1111111111122333322111111111111111111111
1111111111122333322111111111111111111111
1111111111122333322111111111111111111111
1111111111122333322111111111111111111111
1111111111122333322111111111111111111111
1111111111122333322111111111111111111111
1111111111122333322111111111111111111111
1111111111122333322111111111111111111111
1111111111223333221111111111111111111111
1111111112233332211111111111111111111111
1111111122333322111111111111111111111111
1111111223333221111111111111111111111111
1111112233332211111111111111111111111111
1111122333322111111111111111111111111111
1111223333221111111111111111111111111111
1111223333221111111111111111111111111111
1111223333221111111111111111111111111111
1111223333221111111111111111111111111111
1111122333322111111111111111111111111111
1111112233332211111111111111111111111111
1111111223333221111111111111111111111111
1111111122333322111111111111111111111111
1111111112233332211111111111111111111111
1111111111223333221111111111111111111111
1111111111122333322111111111111111111111